111111111111111111111111111111111111111
1                  2                  1
1                3 2                  1
1                  2                  1
1              22222                  1
1                 22                  1
1                 22                  1
1                 2                   1
1                 221                 1
1 11111                222      1111111
1                 222                 1
1                 222                 1
1      2           222        2       1
1                 212                 1
1                 212                 1
1      2           212        2       1
1      2           212        2       1
1                 212                 1
1              222212                 1
11111111       222222                 1
1              22  22                 1
1              22  22                 1
1              222222        1111111111
1              212222                 1
1              21                     1
1      22        21      22           1
1              21                     1
1              22                     1
1    2 2         22      2  2         1
1              22                     1
1              22                     1
1   11111222111111111222111111        1
1               2                     1
1               2                     1
1               2                     1
1  222222             111111222222    1
1             1                       1
1             1  4                    1
1             1                       1
111111111111111111111111111111111111111